UIL	Quillayute,_WA
SLE	Salem,_OR
MFR	Medford,_OR
OAK	Oakland,_CA
VBG	Vandenberg_AFB,_CA
EDW	Edwards_AFB,_CA
DRA	Mercury/Desert_Rock,_NV
REV	Reno,_NV
BOI	Boise,_ID
GGW	Longview,_TX
SLC	Salt_Lake_City,_UT
FGZ	Flagstaff,_AZ
TUS	Tucson,_AZ
ABQ	Albuquerque,_NM
DNR	Denver,_CO
BIS	Bismarck,_ND
ABR	Aberdeen,_SD
LBF	North_Platte,_NE
OAX	Omaha,_NE
TOP	Topeka,_KS
DDC	Dodge_City,_KS
OKC	Oklahoma_City,_OK
AMA	Amarillo,_TX
MAF	Midland,_TX
FWD	Fort_Worth,_TX
DRT	Del_Rio,_TX
CRP	Corpus_Christi,_TX
BRO	Brownsville,_TX
INL	International_Falls,_MN
MPX	Chanhassen,_MN
DVN	Quad_Cities,_IA
SGF	Springfield,_MO
LZK	Little_Rock,_AR
SHV	Shreveport,_LA
LCH	Lake_Charles,_LA
GRB	Green_Bay,_WI
ILX	Lincoln,_IL
JAN	Jacksonville,_MS
SIL	Slidell,_LA
SSM	Sault_Ste._Marie,_MI
DTX	Detroit,_MI
ILN	Wilmington,_OH
FTK	Fort_Knox,_KY
BNA	Nashville,_KY
BMX	Shelby_Co,_AL
BUF	Buffalo,_NY
PIT	Pittsburgh,_PA
FFC	Peachtree_City,_GA
TLH	Tallahassee,_FL
JAX	Jacksonville,_FL
XMR	Kennedy_AFS,_FL
TBW	Tampa,_FL
MFL	Miami,_FL
EYW	Key_West,_FL
MHX	Newport,_NC
GSO	Greensboro,_NC
WAL	Wallops_Island,_VA
ALB	Albany,_NY
CHH	Chatham,_MA
CAR	Caribou,_ME
